##########
#E CX CX #
#   CX CX#
#  CX CX #
#   CX CX#
#  CX CX #
#   CX CX#
#  CX CX #
#   CX CX#
##########
