##########
#X     OX#
#O  E    #
#   b    #
# CXCCC  #
# CCCXCC #
#        #
#X  X  BX#
#O     XX#
##########
