##########
#   ECX  #
#   CX   #
#    CX  #
#  O     #
#    CX  #
#     P  #
#    CX  #
#   XC   #
##########
