##########
# X C X  #
#C# #   C#
# # #OCO #
#X      X#
#C C  X C#
#X  #O   #
## X#OCCX#
#XC #OEXO#
##########
