##########
# OOOOO#X#
# XXXXX# #
# CCCCC#C#
#        #
# ########
# #XX#   #
# #CC# # #
#      #E#
##########