##########
#E#O CX  #
# #O     #
# ###### #
#      # #
###### # #
#      # #
# ###### #
#        #
##########