##########
# E      #
# CXC  X #
#  CX XC #
#   CXC  #
#   XXC  #
# CX CX  #
# XC  CX #
#        #
##########