OOOOOOOOOO
OOOOOOOOOO
##########
#   %X X #
#   %  # #
#E m%C C #
######   #
OOOOO#####
OOOOOOOOOO
OOOOOOOOOO
