##########
# C  XX#X#
#   O  # #
######C# #
#X     C #
##C##### #
O#     #C#
O# OXC # #
O#XOXC #E#
O#########
